0 0 1 0 P 0 e 0 p 0 1 0 P 0 e 0 p 0 0 1 0 P 0 e 0 p 0 1 1 1 1
1 0 p 0 1 E 1 0 1 0 0 1 0 p 0 1 E 1 0 1 0 1 0 p 0 1 E 1 0 1 0
1 G 1 0 1 0 1 0 0 K 1 K 1 0 1 0 1 0 0 K 1 K 1 0 1 0 1 0 0 K 1
0 0 P 0 p 0 0 0 1 0 0 0 P 0 p 0 0 0 1 0 0 0 P 0 p 1 0 0 1 0 1
0 1 1 0 E 1 1 0 1 0 0 1 1 0 K 1 1 0 1 0 0 1 1 0 K C 1 0 1 0 1
p 0 0 0 1 0 p 0 0 0 0 0 0 0 1 0 p 0 0 0 0 0 0 0 1 1 p 0 0 0 1
1 0 P 0 e 0 p 0 1 0 P 0 E 0 p 0 1 0 P 0 e 0 p 0 1 1 P 0 e 0 p
1 E 1 0 1 0 0 1 0 p 0 1 E 1 0 1 0 0 1 0 p 0 1 E 1 0 1 p 0 1 0
1 0 1 0 1 0 1 0 0 K 1 0 1 0 1 0 1 0 0 K 1 0 1 0 1 0 1 0 E K 1
1 0 P 0 p 0 0 0 1 0 0 0 P 0 p 0 0 0 1 0 0 0 P 0 p 0 0 0 1 0 1
0 1 E 1 0 1 0 1 0 p 0 0 1 E 1 0 1 0 1 0 p 0 0 1 E 1 0 1 0 1 1
0 0 0 0 1 0 p 0 0 0 0 0 0 0 1 0 p 0 0 0 0 0 0 0 1 0 p 0 0 0 1
1 0 P 0 e 0 p 0 1 0 P 0 p 0 p 0 1 0 P 0 e 0 p 0 1 0 P 0 e 0 p
1 E 1 0 1 0 0 1 0 p 0 1 E 1 0 1 0 0 1 0 p 0 1 E 1 0 1 0 0 1 0
1 0 1 0 1 0 1 0 0 K 1 0 1 0 1 0 1 0 0 K 1 0 1 0 1 0 1 0 0 K 1
0 0 P 0 p 0 0 0 1 0 0 0 P 0 p 0 0 0 1 0 0 0 P 0 p 1 0 0 1 0 C
0 1 1 0 K C 1 0 1 0 0 1 1 0 K C 1 0 1 0 0 1 1 0 K C 1 0 1 0 K
E 0 0 0 1 0 p 0 0 0 0 0 0 0 1 1 p 0 0 0 0 0 E 0 1 1 p 0 0 0 p